11111111111111111111111111
1P01C1C0E0EC10100C000000C1
11C00000000000C0010C010C01
10000000000100C00100000C01
11C00000000100000100010001
10010C1111C00C01110C010001
10010001101101111C00000111
1C000000001100100001110001
10001C0000000010000C010001
1010C0000C0C0C00001C01C001
10000C0001100000000000C001
1010000000100000C000001111
10100C0011C00010000000C001
1C100111100000100010011011
11111111111111111111111111