11111111111111111111111111
1P00000C000C0000000C000001
10111010001000000010010001
101C0010001011100010010001
101000100C001010C0000100C1
10100010100011101000111001
1C1110001000C00010000000C1
1000000C100000001C000C00E1
11111111111111111111111111