111111111111111111111111111
1PCCCCCCCCCCCCCCCCCCCCCCCC1
1111111111111111111111111C1
1CCCCCCCCCCCCCCCCCCCCCCCCC1
1C1111111111111111111111111
1C1CCC1CCC1CCC1CCC1CCC1CCC1
1C1C1C1C1C1C1C1C1C1C1C1C1C1
1CCC1CCC1CCC1CCC1CCC1CCC1E1
111111111111111111111111111