11111111
1C0000E1
11C100C1
1P010101
11111111
